1112221111
1222222221
1222222221
1222222221
2222222222
2222222222
2222222222
1222222221
1222222221
1112221111
