1111221111
1112222111
1123223211
1322222231
1123223211
1112222111
1111221111