11122211111112221111
12222222222222222221
13222222222222222321
12222222222222222221
22222222222222222222
22222222222222222222
22222222222222222222
12222211111112222221
12222212222212222221
12222212232212222221
12222212222212222221
12222213223212222221
12222211222112222221
12222222222222222221
22222222222222222222
22222222222222222222
22222222222222222222
12222222222222222221
13222222222222222321
11122211111112221111