1111221111
1222222221
1222222221
1223232221
2223232222
2222222222
2222222222
1222222221
1222222221
1111221111
