122111221
122212221
113222311
112232211
113222311
122212221
122111221