1111111111
1222222221
1222222221
1222222221
3222322223
1222222221
1222222221
1222222221
1222222221
1111111111
